NO ./texture/eagle.xpm
SO ./texture/wolftextures.xpm
WE ./texture/wolftextures.xpm
EA ./texture/wolftextures.xpm

F 220,100,0
C 225,30,0

1   11111111111111111
11   1000000000000001
101   100000111000001
1001   100000000E0001
10001   1000000000001
100001   100000000001
1111111   11111111111
