NO textures/wood.xpm
SO textures/redbrick.xpm
WE textures/eagle.xpm
EA textures/colorstone.xpm

F 220,100,0
C 225,30,0

1111111111
1E00000001
1111111101
1000000101
1011110101
1010010101
1010000101
1011111101
1000000001
1111111111