NO textures/wood.xpm
SO textures/redbrick.xpm
WE textures/eagle.xpm
EA textures/colorstone.xpm

F 220,100,0
C 225,30,0

1111111111
1000000001
1011001101
1000000001
1000100001
1000000101
1000000101
1000N00101
1001110001
1111111111