NO ./texture/eagle.xpm
SO ./texture/wolftextures.xpm
WE ./texture/wolftextures.xpm
EA ./texture/wolftextures.xpm

F 220,100,0
C 225,30,0

11111111          11111111
10000001111111111110000001
10000000000000000000000001
10000000000000000011111111
1000N00000000000001
1000000111111111111
11111111
